NO ./assets/textures/north_texture.xpm
		WE ./assets/textures/west_texture.xpm
SO ./assets/textures/south_texture.xpm

EA ./assets/textures/east_texture.xpm
   C        225,31,2           
		F 220,100,42




11111111111111111
   100000111111111111
    10000000S00000001
111111000000000000001
111111000000000000001
100000000000000111111
1000001111111111
1111011111111111111111111111
10              0001

