NO ./assets/textures/north_texture.xpm
SO ./assets/textures/south_texture.xpm
WE ./assets/textures/west_texture.xpm
EA ./assets/textures/east_texture.xpm
F 220,100,110
C 225,30,0

110111
10N001
100001
111111