NO ./assets/textures/north_texture.xpm
SO ./assets/textures/south_texture.xpm
EA ./assets/textures/east_texture.xpm
WE ./assets/textures/west_texture.xpm
C 225,31,2
F 220,100,0

111111111111111111111111111
100000000000000000000000001
100000001111111111111111111
1	1    1            111
100001            111
10000000111111111111111111111
100000000000000000000000001
100000000000000000000000001
1000000000000S  00000000001
111111111111111111111111111
1   1
11  1
111 1
11111