NO ./assets/textures/north_texture.xpm
SO ./assets/textures/south_texture.xpm
EA ./assets/textures/east_texture.xpm
WE ./assets/textures/west_texture.xpm
C 225,31,2
F 220,100,0

111111111111111111111111111
100000000000000000000000001
100000111111111111111111111
1000001
100000111111111111111111111
100000000000000000000000001
100000000000000000000000001
1000000000000E0000000000001
111111111111111111111111111
