NO ./assets/textures/north_texture.xpm
SO ./assets/textures/south_texture.xpm
EA ./assets/textures/east_texture.xpm
WE ./assets/textures/west_texture.xpm
C 30,144,255
F 240,230,140

         11111111111111111111111111111
         10000000001100000000000000001
         10110000011100000001111111111
11111111110000000000000000011111
        101100000111000000000111111
11111111100110000011101111011
11110111111111011100000010001
11110111111111011101010010001
1100S000110101011100000010001
10000000000000001100000010001
10000000000000001100010000001
11000000110101000000000000001
11110111110101000000000000001
10000000001100000100000010001
10000000000000000000000001001
10000000111100010000000001001
100000001  100110101110000001
10000000111110000001 10100001
10000000111110000001 10100001
10000000111110000001 10100001
10000000111110000001 10100001
10000000111110000001 10100001
10000000111110000001 10100001
10000000111110000001 10100001
10000000111110000001 10100001
10000000111110000001 10100001
11111111111111111111 11111111