NO ./assets/textures/north_texture.xpm
SO ./assets/textures/south_texture.xpm
EA ./assets/textures/east_texture.xpm
WE ./assets/textures/west_texture.xpm
C 192,192,192
F 255,255,255

11111111111111
10000000000001
10100000010001
10000100010001
1000000N000001
10000100010001
10100010001001
10000000000001
11111111111111
